#^.^~****^*~~.~^~..~~~^~.^~.*~**.^^*^*^~..*^^..~^.
*#*~*#~^^^~~.*~*.**.~~^*^**.^~*^^.*^...^..^.**.~^*
^^#*#~##^*^..^**.~~~.~*.~^^~^~^.^~^*~**.~*^.^**.*.
*~~#~^.~#~^~^^*^**.~.*^^*~~^^*~.^.*^^*^.^.~~^^^*~.
*.^~^^.~^#^.^^*~^~~*^..^~^~~^.*^^..**.**~.~~^~*~**
^.^^~^.*~*##*~*^*~^*~~^.^.~.~^**~.^^^^*.~.~~~^^.^.
*~~.*.^~~~^*#^*~~~*^.^**^*^.^.^~~***^^*^.~^^.^^.~.
.~.*~~^*.**#~^^~**^.^.^~~~^.~.^~~^^.~^^.^^~.~.~.*^
.^^^~~*~.^.~#*~.~~..~*~^.~**~..^****~.*~^~~*~**^~^
^^^*^^**...*.#^*^^^.*~*~^^~*~~.~****~~~~***.^^~~^~
..*^^^^^.^~.^~#^.^^~*~^*~**^*^.~~~*^.^^~**~*~.....
**.^~~~^~*~****##*^~.^.*^^^~.^...~.**^^^^~^.~^~.~*
^*~.*.~*^.~.^^^^^#~.**~^.*^*.~~..^~~~*~*^.~~^*^*^^
~*^.^..**~**^*^~**#^~~*^*.*~..~^^***^.*~.^*^^^^.~.
*~^~^**^^*^^~^*~^^#~~~*^*~~~~*~^^^*~..~~~~~.*~^~*.
^.*.^*^**^^^~**.*.~#~~~^..~~~*~~^*~..^^.^~*.^~^~**
.***^..*^~~~~^~.*^~~#*.~^.^^*.***^~^.*....~.^.*~^^
^^~~~~.**.*.^^*.^~~^.#..*~*^~*^^.^~~~^*.~^^^~**^~~
^~~*^*.~.*^^^*^.*..~*.#.~**^.^^~.^^.^..^.^**.^^..*
~^***~^.~.~^^^*~~~.*.#^~^^.~^.~.**...~^~**~^~~**^~
~~~^~.^*.^*.~*.*~~^.#~*^^~~**.*.*.~^^^..^.~^.*.^~~
^^~...^.*~.^^**~^~*.#^~^~*....^.^^**~.*.^^*..~*~.*
^..^...~.~.*.~***~*~~#..~*~^^~~^~**^~~^*^^~*.~*^*^
*^.**^~*****.~~~..~^~#*.^*~^.^^*^..*~^.^.^*.^.~^^*
~...~*^....*^.*^^*...^#~~..^.*~.*~.*^.^*^*^.****^~
^..~***^.*^~~.****.~*^#~.^~*.~^*^~^.****~..~*..*^~
.~^~**~^^..~~~^..*~*.^*#~..^^*.~.*..*~~*~.^~.~*~~.
.***~..~**^.~.~.~*.~~**.#^.^~..~*~~~~*.**~~^..^.^^
~.*.~^*^*~^.~*..*~^~~.*.*#.*.*..^~.*~^^*.~^.^~^**^
.*^~^^*.^*.~*...*~~~*.**.~###*.*^.^*.^*~*.^~^**^*.
.~..*....~..~.***~..~^..~~^*^#^~^^~~**^.*~**^**^^*
^.*.~.^.**^*^.~^^*.~..*^~*^***#~**..^.~~*..^*^~*.~
^~~^~~*.~^^~~^**.^.^^^*^.*^^~~#^.*~^*^^..**..**..^
^.^*.*^..*.~~.^^***^.*~..~.**^*#~^...^^~*.~^~^..~~
~^^.^..*^^.**.~~^*~*^~*~^~~.~*#^~.~*^~*.*..^.^^*^*
^^.~*^~~*.~~*~.^..~*.^.~**.^*^#^~.**.~*.~...~~..*.
.~..^.~.~.^*.~^*~.~.*^*~~*.^.**#***~*~~*^~~~^.~~*~
~.*..^^*^~*.~~.~.^~..~.~^^^.*~*.##~^*~*^*^^~..^~^^
*.^*^**^*.^^*....**..~^^~.^*^.*~*^#*^^##*.^^*^^^.~
^*^~^^*.~*~^*~^~~.*.^*^~*^^~.*~.*~.###*~#~~.~*^~~*
~~**~*.^.*~..~~^^^~^^^.~***^*.^*~^*~^~*~*##..~..~.
*~**^~~.^.*.~^**~*^^.*^*.^~~*~~~*^.*..~~^*^#*^.^.*
.*^~..*~.*^^^^^~~^^*.~*.~~~.***~^.*..~~*****#~~^*.
.^^..^.^*^~^.~*...**~~~.**^*~~~*^***~^*^~^~~^#^*.*
**.**~.**~.*.*^~~.~^.*^.~~*.^*.~.***~*^^..~*.~#^*^
~..^.****^.****~^~***..^^^^*^.~*^^*.~~.^**^*~^*#~~
^*~^.~*...^^.^~.^^..~^...**...^****^*~*~*^..~^*~#~
...^~^.~^^~~~~.*^~.^~***~~^^^.*^^.~.^*~*~**^***^~#
.~~~~~^^.~~*^.~^^^**~^~.^~^~*..^*~^^*..*~^~**.*.^#
~^**.~**..*^~^^^.^*^~^~*^.~*~.^.**.^.^^.~**^~~^~^#
